###########################################################################################
#.....................................#...................................................#
#.....................................#...................................................#
#.....................................#...................................................#
#.....................................#...................................................#
#.....................................#...................................................#
#.....................................#..#................................................#
#.....................................#..#................................................#
#.....................................#..#................................................#
#........................................#................................................#
#.....................................####................................................#
#.....................................#...................................................#
#.....................................#...................................................#
#.....................................#...................................................#
#.....................................#...................................................#
#.....................................#...................................................#
#.....................................#...................................................#
###########################################################################################
