###########################################################################################
#z.............................................g#.........................................>
#...............................................=.........................................#
#...............................................=.........................................#
#...............................................=.........................................#
#...............................................=.........................................#
#...............................................=.........................................#
#...............................................=.........................................#
#...............................................=.........................................#
#...............................................=.........................................#
#...............................................=.........................................#
#...............................................=.........................................#
#...............................................=.........................................#
#...............................................=.........................................#
#...............................................=.........................................#
#...............................................=.........................................#
#g..............................................=.........................................#
###########################################################################################
