###########################################################################################
#.....................................#..........................=........................>
#.....................................#..........................=........................#
#.....................................#..........................=........................#
#.....................................#..........................=........................#
#.....................................#..........................=........................#
#...........z.........................#..#.......................=........................#
#.....................................#..#.......................=........................#
#.....................................#..#.......................=........................#
#........................................#.......................=........................#
#.....................................####.......................=........................#
#.....................................#..........................=........................#
#..............................g......#..........................=........................#
#.....................................#..........................=........................#
#.....................................#..........................=........................#
#.....................................#..........................=........................#
#.....................................#...................................................#
###########################################################################################
