###########################################################################################
#z..................................................#..................................=.>
#...................................................#..................................==.#
#...................................................#.................................=...#
#...................................................#...................................==#
#...................................................#.....................................#
#...................................................#.....................................#
#...................................................#.....................................#
#...... ............................................#.....................................#
#...................................................#.....................................#
#...................................................#.....................................#
#..................................................g.. ...................................#
#...................................................# =...................................#
#...................................................#.....................................#
#...................................................#.....................................#
#...................................................#.....................................#
#...................................................#.=================================...#
###########################################################################################
